%%%%%%%%%%%%%%
%P           %
%            %
%            %
%            %
%            %
%            %
%           G%
%%%%%%%%%%%%%%
% % % %%%%%%%%
%%%%%%%%%%%%%%
