%%%%%%%%%%%%%%
%%%%%%% %%%%%%
%%%%%%% %%%%%%
%%%%%%% %%%%%%
%%%%%%%P%%%%%%
%%%%%%% %%%%%%
%%%%%%% %%%%%%
%%%%%%%G%%%%%%
%%%%%%%%%%%%%%
% %%%%%%%%%%%%
%%%%%%%%%%%%%%