%%%%%%%%%%%%%%
%G     P     %
%%%%%%%%%%%%%%
% %%%%%%%%%%%%
%%%%%%%%%%%%%%