%%%%%%%%%%%%%%
%      P    G%
%%%%%%%%%%%%%%
% %%%%%%%%%%%%
%%%%%%%%%%%%%%