%%%%%%%%%%%%%%
%%%%%%%G%%%%%%
%%%%%%% %%%%%%
%%%%%%% %%%%%%
%%%%%%%P%%%%%%
%%%%%%% %%%%%%
%%%%%%% %%%%%%
%%%%%%% %%%%%%
%%%%%%%%%%%%%%
% %%%%%%%%%%%%
%%%%%%%%%%%%%%