%%%%%%%%%%%%%%
%P           %
%       %%%%%%
%            %
%            %
%%%%%%       %
%       %%%%%%
%           G%
%%%%%%%%%%%%%%
% %%%%%%%%%%%%
%%%%%%%%%%%%%%
