%%%%%%%%%%%%%%
%           G%
%        %%%%%
%            %
%%%%%%%%     %
%            %
%            %
%P           %
%%%%%%%%%%%%%%
% % % %%%%%%%%
%%%%%%%%%%%%%%
