%%%%%%%%%%%%%%
%            %
%            %
%     % %    %
%     %G%    %
%     %%%    %
%            %
%           P%
%%%%%%%%%%%%%%
% %%%%%%%%%%%%
%%%%%%%%%%%%%%