%%%%%%%%%%%%%%
%P           %
%            %
%     %%%    %
%     %G%    %
%     % %    %
%            %
%            %
%%%%%%%%%%%%%%
% %%%%%%%%%%%%
%%%%%%%%%%%%%%