%%%%%%%%%%%%%%
%           G%
%      %%%%%%%
%            %
%            %
%            %
%            %
%P           %
%%%%%%%%%%%%%%
% % % %%%%%%%%
%%%%%%%%%%%%%%
