%%%%%%%%%%%%%%
%            %
%            %
%            %
%      %     %
%      %     %
%      %     %
%G     %    P%
%%%%%%%%%%%%%%
% %%%%%%%%%%%%
%%%%%%%%%%%%%%