%%%%%%%%%%%%%%
%P           %
%%%%%%%      %
%      %     %
%   % G%     %
%   %%%%     %
%            %
%            %
%%%%%%%%%%%%%%
% % % %%%%%%%%
%%%%%%%%%%%%%%
