%%%%%%%%%%%%%%
%            %
%            %
%            %
% %          %
% %          %
% %          %
%G%         P%
%%%%%%%%%%%%%%
% %%%%%%%%%%%%
%%%%%%%%%%%%%%