%%%%%%%%%%%%%%%%%%%%%%%%%%%%
%                          %
% %%%%%%%%%%%%%%%%%%%%%%%% %
%           P%G            %
% %%%%%%%%%%%%%%%%%%%%%%%% %
%                          %
%%%%%%%%%%%%%%%%%%%%%%%%%%%%
% % % % % % %%%%%%%%%%%%%%%%
%%%%%%%%%%%%%%%%%%%%%%%%%%%%
