%%%%%%%%%%%%%%%%%%%%%%%%%%%%
%                          %
% %%%%%%%%%%%%%%%%%%%%%%%% %
%           G%P            %
% %%%%%%%%%%%%%%%%%%%%%%%% %
%                          %
%%%%%%%%%%%%%%%%%%%%%%%%%%%%
% % % % % % %%%%%%%%%%%%%%%%
%%%%%%%%%%%%%%%%%%%%%%%%%%%%