%%%%%%%%%%%%%%%%%
%%%%%%%%%%%     %
%%%%%%%%%%% % % %
%%%%%%%%%%% %G% %
%%%%%%%%%%% %%% %
%%%%%%%%%%% %P% %
%%%%%%%%%%% % % %
%%%%%%%%%%% % % %
%%%%%%%%%%% % % %
%%%%%%%%%%%     %
%%%%%%%%%%%%%%%%%
% % % % % % %%%%%
%%%%%%%%%%%%%%%%%