%%%%%%%%%%%%%%%%%
%%%%%%%%%%%     %
%%%%%%%%%%% % % %
%%%%%%%%%%% %P% %
%%%%%%%%%%% %%% %
%%%%%%%%%%% %G% %
%%%%%%%%%%% % % %
%%%%%%%%%%% % % %
%%%%%%%%%%% % % %
%%%%%%%%%%%     %
%%%%%%%%%%%%%%%%%
% % % % % % %%%%%
%%%%%%%%%%%%%%%%%